10
10
##########
#_FFF_###T
#F___#####
##FF_#####
#____##FF#
#____##TF#
#FFF____F#
#FFFFF__F#
##FFFFFXF#
##FFF##T##