20
20
____________________
#_T______________###
##FFF__________#####
##FFFF_________#####
##FFFFF________##FF#
##FFFFFF_______##FF#
##FFFFFF__T____##FF#
##FFFFFF_______##FF#
##FFFFFF_______#####
##FFFFFF_______#####
##FFFFFF_______#####
##FFFFFF______T#####
##FFFFFF__________##
##FFFFFF#######___##
##FFFFFF#######_FF_#
###########FFT____FF
##FFFFFF__________##
##FFFFFF__FFFFF___##
##FFFFFF__________X#
##FFF######FFF#T#FFF